


                                      ╔═══════════════════════════════╗
                                      ║        🐦                     ║
                                      ║    ┌─────────╴🐦╶────────┐    ║
                                      ║    │                     │ 🐦 ║
                                      ║    │    ┌───────────┐    │    ║
                                      ║    │    │           │    │    ║
                                      ║    │    │    ┌─┐    │    │    ║
                                      ║    │    │    │ │    │    │    ║
                                      ║    │    ╵    │ │    │    │    ║
                                      ║    │    🐦   │ │    │    │    ║
                                      ║    │    ╷    │ │    │    │    ║
                                      ║ 🐦 │    └────┴─┴────┘    │    ║
                                      ║    │                     │    ║
                                      ║    └─────────────────────┘    ║
                                      ║                               ║
                                      ╚═══════════════════════════════╝
